8 5
1 2
6 2
11011111
11011011
10000000
11010111
11010111