10 7
1 1
8 5
1111111011
1011100011
1000001011
1110100000
1110001111
1111100001
1111101111